...................
.W...............S.
..###############..
................#..
..#.............#..
..#...#######...#..
..#...#.ggg.....#..
..#######r#######..
..#.....ggg.#...#..
..#...#######...#..
..#.............#..
..#................
..###############..
.s...............w.
...................
